...............#....
....................
..................#.
....................
....................
..............#.....
....................
....###.............
.........###........
....................
....................
....###.......###...
....................
.1..................
#########..#########
